0 0 6 0 0 2 7 7 2 0 0 7
0 0 1 1 1 2 1 1 2 1 1 1
0 0 1 8 8 2 1 1 2 8 8 1
0 0 1 2 6 2 1 1 2 7 6 1
0 0 1 2 1 1 1 1 1 1 1 1
0 0 1 2 8 8 8 8 8 8 8 1
0 0 1 2 8 6 8 7 8 7 2 1
0 0 1 1 1 1 1 1 1 1 2 1
0 0 1 8 8 8 8 8 8 8 2 1
H 5 8 8 6 8 8 7 8 8 2 1
3 1 4 1 1 1 1 1 1 1 1 4
3 3 3 3 3 3 3 3 3 3 3 3