0 0 0 0 0 0 0 0 0 0 0 0
0 0 0 0 0 0 0 0 0 0 0 0
0 0 0 0 0 0 0 0 0 0 0 0
0 0 0 0 0 0 0 0 0 0 0 0
0 0 0 0 0 0 0 0 0 0 0 0
0 0 0 0 0 0 0 0 0 0 0 0
0 0 0 0 0 0 0 0 0 0 0 0
0 0 2 1 2 4 4 4 4 4 0 0
0 0 2 1 2 0 0 0 0 4 0 0
0 0 2 1 2 0 0 0 0 4 0 0
0 0 2 1 2 0 0 0 0 0 0 0
3 3 3 3 3 3 3 3 3 3 3 3