0 0 0 2 0 6 0 0 6 0 2 0
0 0 1 2 1 1 1 1 1 1 2 1
0 0 1 2 8 8 1 1 8 8 2 1
0 0 1 2 8 7 1 1 7 8 2 1
0 0 1 2 1 1 1 1 1 1 2 1
0 0 1 2 8 8 1 1 8 8 2 1
0 0 1 2 8 6 1 1 8 8 2 1
0 0 1 2 1 1 1 1 1 1 2 1
0 0 1 2 8 8 1 1 8 8 2 1
H 5 8 2 8 7 1 4 7 8 2 1
3 1 1 1 1 1 1 1 1 1 1 1
3 3 3 3 3 3 3 3 3 3 3 3