0 0 0 0 0 0 0 0 0 0 0 0
0 0 0 0 0 0 0 0 0 0 0 0
0 0 1 2 1 1 1 1 1 1 2 1
0 0 1 2 8 8 8 8 8 1 2 1
0 0 1 2 8 8 8 8 8 1 2 1
0 0 6 2 8 7 8 7 6 8 2 1
0 0 2 1 2 1 1 1 1 1 2 1
0 0 2 1 2 8 8 8 8 1 2 1
0 0 2 1 2 8 8 8 8 1 2 1
0 5 2 1 2 7 8 7 8 8 2 1
1 1 1 1 1 1 1 1 1 1 1 4
3 3 3 3 3 3 3 3 3 3 3 3